5 1 11 11
11111111111
00000S00000
10000000001
11111011111
10001010001
10001000001
10001010001
10001110001
10000000001
10001110001
11111111111

4 1 11 11
11111111111
10000000000
10000000001
11111011111
11111011111
11111011111
11111011111
11111011111
11111011111
11111011111
11111011111

6 1 11 11
11111111111
00001111001
10000000001
11111011111
11111011111
11111011111
11111011111
11111011111
11111011111
11111011111
11111011111

3 2 11 11
11111111111
10011110000
10000000001
11111011111
11111011111
11111011111
11111011111
11111011111
11111011111
11111011111
11111011111

4 2 11 11
11111011111
00000000001
10110001101
11111011111
11111011111
11111011111
11111011111
11111011111
11111011111
11111011111
11111011111

5 2 11 11
11111111111
10000000001
10000000001
10011111001
11000000011
11110001111
10000000001
10011111001
10111111101
10000000001
11111011111

6 2 11 11
11111011111
10000000000
10000000001
11111111111

7 2 11 11
11111111111
00100000101
10001010001
11111011111
11111011111
11111011111
11111011111
11111011111
11111011111
11111011111
11111011111

2 3 11 11
11111111111
11010001000
10010001001
10110001101
10010001001
11010001011
10010001001
10110001101
10010001001
10000000001
11111111111

3 3 11 11
11111011111
00101000001
10000000001
11111111111

4 3 11 11
11111011111
10111011100
10010001001
10000000001
11111111111
11111111111

5 3 11 11
11111011111
00010001000
10000000001
11111011111
11111011111
11111011111
11111011111
11111011111
11111011111
11111011111
11111011111

6 3 11 11
11111111111
00100010000
10001000101
11111111111

7 3 11 11
11111011111
00110001100
10000000001
11111011111
11111011111
11111011111
11111011111
11111011111
11111011111
11111011111
11111011111

8 3 11 11
11111111111
00000000001
10000000001
11111001111
10001001001
10001001001
10000001001
10000001001
10000000001
11111011111
11111011111

1 4 11 11
G

2 4 11 11
11111111111
00000000000
10000000001
11111111111

3 4 11 11
11111111111
00000000000
10000000001
11111111111

4 4 11 11
11111111111
00111111100
10010001001
10000100001
11111111111
11111111111

5 4 11 11
11111011111
00000000000
10000000001
11111111111

6 4 11 11
11111111111
00111111101
10010000101
10000000001
11111111111
11111111111

7 4 11 11
11111011111
10110001100
10000000001
11111111111

8 4 11 11
11111011111
00111011100
10010001001
11000000001
11111111111
11111111111

9 4 11 11
11111111111
00000000001
10000000001
11111111111