1 1 10 10
1111111111
10000000K1
1000000001
1000000001
10000S000D
1000000001
1000000001
1000000001
1000000001
1111111111

2 1 10 10
1111111111
1000000001
1000000001
1000000001
000000000D
1000000001
1000000001
1000000001
1K00000001
1111111111

3 1 10 10
1111111111
1000000001
1000000001
1000000001
000000000D
1000000001
1000000001
1000000001
10000000K1
1111111111

4 1 10 10
G