1 1 10 10
1111111111
1000000001
1000000001
1000000001
10000S0001
1000000001
1000000001
1000000001
1K00000001
11111111D1

1 2 10 10
G